|----------------------------------------------------------------------------------------------------------------------|
|                         #####################                                                                        |
|                    #########♥#############                                                                           |
|  ----------------------------------------------|                                                                     |
|          |       |   |   |   |       | |   |   |                                                                     |
|| ------- |-- ----| | |-- |-- | --- --| | --| | |##----------------|                                                  |
||   |     |         | |   |     |   |   |   | | |################  |#####   ##############################    ########|
||-- | | --| --- | ----|-- |-- | | --|-- | --|-| |----------------##|######   ##################            ###########|
|| | | |   | |   |     |     | | |   |       |   |         ♠        |#####    ##############       ####### ############|
|| | |-| ----| | |-- | |-- --|-|-|-- ------- | | |##----------------|#######      ##########    ##############   ######|
||   | | |   | | | | | |     |   |       |     | |#########         |#########     ########   ###########       #######|
||-- | | | | | |-| | |-| --- |-- |---- ----- ----|----------------##|########     ###########  ###########  ###########|
||   |     | | |   |   | |   |     |         |   |         ♥        |###          ##########   ############  ##########|
||---|-- |-| |-|-- |-- |-|-- | ----|-- | | | | | |##----------------|##  ####                                 #########|
||   |   | | |     |     |   | |   |   | | | | | |############      |#   #######   ##########    #######  ########  ###|
|| --| --| |-|-- | | --- | --| | --| --|-|-| | --|----------------##|##   ####♥##  ###########    #####     ####     ##|
||     | |   |   |     | | |     |   | | |   |   |         ♠        |##  ######    #############       ###        #####|
||-- --- | ------| ------| |---- | | | | |-- | --|##----------------|##     ####    #####     ####  ##     ############|
||   |   |     |         | | | |   |     |       |###########       |####    ######       ########   ####   ###########|
|| | |-- | --- | | ----- | | | |---| --- |-------|----------------##|########   ###   ######        #######   #########|
|| | |   | |     |   |   |   |     | |   |       |         ♥        |#####    #####  ######  ######  ####       #######|
|| | | --| | ----|-- | | | | | | --| | --|-- | | |##----------------|####       ##########   #######  #######     #####|
|| |       |   |     | |   | | |     | |   | | | |#############     |#####    ###########    #######    #########   ###|
|| ----- | | --|-- --|-| | |-| | ----| | --|-| |-|----------------##|#######   #######     ############   ######   ####|
||   |   | | |   | |     | |   |   |       |     |  ♥ ♠             |###         ######################################|
||---| --| | |-- |-|-- | | |-- ----| | --- | --- |------------------|##    #####    ###################################|
||       | |     |     | |         | | |       |                    |##################################################|
||-------|-|-----|-----|-|---------|-|-|-------|                    |##################################################|
|----------------------------------------------------------------------------------------------------------------------|